5 5
1 4
4 3
3 4 3 3 5
0 5 1 0 4
4 3 3 5 5
5 2 2 4 4
5 4 1 1 1
