5 5
4 2
0 1
1 1 0 5 3
2 1 1 4 0
0 3 3 4 4
1 1 3 0 2
5 2 3 3 4
