10 5
7 3
1 0
5 3 4 0 5
1 0 2 5 0
1 4 4 2 1
0 2 0 5 1
1 5 1 1 2
0 2 5 0 3
1 1 1 4 5
3 0 5 5 3
4 1 5 3 4
0 2 4 1 1
