10 10
9 8
5 2
5 0 2 0 3 1 3 1 0 1
3 1 5 3 5 4 4 2 2 0
5 3 4 4 2 1 2 0 4 4
2 2 0 2 4 0 2 3 0 2
1 3 5 4 0 1 4 2 5 2
2 5 4 1 1 5 1 2 1 3
0 2 0 1 1 0 1 3 3 3
3 3 2 4 4 3 4 3 5 5
1 3 4 5 3 0 1 0 4 5
2 3 0 1 5 5 1 1 4 2
